NO ./textures/north.xpm
WE ./textures/west.xpm
SO ./textures/south.xpm
EA ./textures/east.xpm

F 200,200,200
C 56,176,222

1111111111111111111111111111111111111111
1000000000000000000000000000000000000001
1000000000000000000000000000000000000001
1000000000100000000000000010000000000001
1000000000000000000000000000000000000001
1000000000100000000000000010000000000001
1000000000000000000000000000000000000001
10000000001N0000000000000010000000000001
1000000000000000000000000000000000000001
1000000000100000000000000010000000000001
1000000000000000000000000000000000000001
1000000000100000000000000010000000000001
1000000000000000000000000000000000000001
1000000000000000000000000000000000000001
1000000000000000000000000000000000000001
1000000000000000000000000000000000000001
1111111111111111111111111111111111111111
