11111111111111
11111110000000
00000000000000
00000000000000
0NWSE001000000
11111111111111