NO ./textures/north.xpm
WE ./textures/west.xpm
SO ./textures/south.xpm
EA ./textures/east.xpm

F 200,200,200
C 56,176,222

        1111111111111111111111111
        1000000000110000000000001
11111111011000001110000000000001
1001000000000000000000001111111111
111111111011000001110000000000001
100000100011000001110111111111111
11110111111111011100000010001
11111011111111111110101001001
110011011011    1011100000011
100000000001    100000010001
10000000000011111110100100011
11000101110101010111011110N0111
11110111101101001101111010001
11111111111111111111111111111
