NO ./textures/north.xpm
WE ./textures/west.xpm
SO ./textures/south.xpm
EA ./textures/east.xpm

F 200,200,200
C 56,176,222

1111111111
        11111111111111
11111110000000
000000000000000
0000000  0000000
0NWSE001000000
11111111111111
